0,0,0,0,0,0,0,0,0,0,0,0,0,0,148,149,0,0,0,0,0,0,0,0,199,174,174,203,174,174,174,174,174,174,174,174,174,174,174,174,
0,94,0,0,0,0,0,0,0,0,0,0,0,0,176,177,0,0,0,0,0,0,0,0,199,174,174,174,174,174,174,174,174,174,174,174,174,174,174,174,
9,10,0,0,0,0,0,0,0,0,0,0,0,0,0,0,0,0,0,0,0,0,0,0,199,174,174,174,174,174,174,174,174,174,203,174,174,174,174,174,
37,38,0,0,0,0,0,0,0,0,0,63,0,0,0,0,0,8,9,10,0,0,0,0,199,174,174,174,175,174,174,174,174,174,174,174,174,174,174,174,
65,66,0,0,0,0,0,0,0,0,0,0,0,0,0,0,0,36,37,38,0,0,0,0,199,174,174,174,174,174,174,174,174,202,174,174,174,202,174,174,
0,0,0,0,0,0,0,0,0,0,0,0,0,0,0,0,0,64,65,66,0,0,0,0,199,174,174,174,174,174,203,174,174,174,174,174,174,174,174,174,
0,0,0,0,0,0,0,0,0,0,0,0,0,0,0,0,0,0,0,0,0,0,0,0,200,170,171,174,202,174,174,174,174,174,174,174,174,174,174,174,
0,0,0,0,0,0,0,0,0,0,0,0,0,0,0,0,0,0,0,0,0,0,0,0,0,0,199,174,174,174,174,174,175,174,174,174,174,174,174,174,
0,0,0,0,0,0,0,0,0,0,0,0,0,0,0,0,62,0,0,0,0,0,0,0,0,0,199,174,174,174,174,174,174,174,174,175,174,174,174,174,
0,0,0,0,0,0,0,0,0,0,0,0,0,0,0,0,0,0,0,0,0,0,0,0,0,0,199,174,174,169,170,171,174,174,174,174,174,174,174,174,
0,0,0,0,0,0,0,0,0,0,0,0,0,0,0,0,0,0,0,0,0,314,0,0,0,0,199,174,174,197,198,199,174,174,174,174,174,174,174,174,
0,0,0,0,0,0,0,0,0,0,0,0,0,0,0,0,0,0,0,91,0,0,0,0,0,0,199,174,174,225,226,227,174,174,174,174,202,174,174,174,
0,0,0,0,0,0,0,0,0,0,0,0,0,0,0,0,0,0,0,119,0,0,0,0,0,0,199,174,174,174,174,174,174,174,174,174,174,174,174,174,
0,0,0,0,0,0,0,0,0,0,0,0,0,0,0,0,0,0,0,0,0,0,0,0,0,0,199,174,174,174,174,174,230,174,174,174,174,174,174,174,
0,0,0,0,0,0,0,0,0,0,0,0,0,0,0,0,0,0,0,0,0,0,0,0,0,0,199,174,174,175,174,174,203,174,174,175,174,174,203,174,
0,0,0,0,0,0,0,0,0,0,0,0,0,0,0,0,0,0,0,0,0,0,0,0,0,0,199,174,174,174,174,174,174,174,174,174,174,174,174,174,
0,0,0,0,0,0,0,0,0,0,0,0,0,0,0,0,0,0,0,0,0,121,121,121,0,0,200,170,170,170,170,171,174,202,174,174,174,174,174,174,
0,0,0,0,0,0,0,0,0,0,0,0,0,0,0,0,0,0,0,0,0,121,94,121,0,0,0,0,0,0,0,200,171,174,174,230,174,174,174,174,
0,0,0,0,0,0,0,0,0,0,0,0,0,0,0,0,0,0,0,0,0,121,94,94,0,63,0,0,0,0,0,0,199,174,174,174,174,174,174,174,
0,8,9,10,0,0,0,0,0,337,338,338,338,338,338,338,338,339,0,0,0,0,0,0,0,0,0,0,0,0,0,0,199,174,174,174,174,174,174,174,
0,36,37,38,0,0,0,0,0,365,0,0,0,0,0,0,0,367,0,0,0,0,0,0,0,0,0,0,0,8,9,10,200,171,174,174,174,202,174,174,
0,64,65,66,0,0,0,0,0,365,0,0,0,0,0,0,0,367,0,0,0,0,0,0,0,0,0,0,0,36,37,38,0,199,174,174,174,174,174,174,
0,0,0,0,0,0,0,0,0,365,178,0,178,0,178,0,178,367,0,0,0,0,0,0,0,0,148,149,0,64,65,66,0,199,174,174,174,174,174,174,
0,0,0,0,0,0,0,0,0,365,94,0,94,0,94,0,94,367,0,0,0,0,0,0,0,0,176,177,0,0,0,0,0,200,171,174,174,174,174,174,
0,0,0,0,0,0,0,0,0,365,0,0,0,0,0,0,0,367,0,0,0,0,0,0,0,0,0,0,0,0,0,0,0,0,199,174,174,174,174,174