6,34,6,6,6,34,6,6,6,34,6,34,6,34,34,34,6,34,34,6,34,34,6,34,34,6,34,6,6,34,34,6,34,6,6,34,34,6,6,6,
34,34,34,6,34,34,6,34,34,6,6,34,34,34,34,34,34,6,34,34,34,34,34,6,6,34,6,6,34,6,34,34,6,6,34,6,6,34,34,34,
34,6,34,6,6,34,34,6,34,6,34,6,6,6,6,34,34,6,34,34,34,6,6,6,34,6,34,34,34,34,6,6,34,34,6,6,34,6,6,6,
6,34,6,6,34,6,34,6,6,6,6,34,34,6,6,34,34,34,34,6,34,34,6,6,34,34,6,6,6,6,6,34,34,6,34,34,34,6,34,6,
34,6,6,34,6,34,6,6,34,34,6,6,34,6,6,6,34,6,34,6,34,34,34,34,34,6,6,6,34,34,34,6,6,6,6,34,6,6,6,34,
34,34,34,34,34,6,6,34,34,34,34,34,6,34,34,6,6,34,34,34,34,6,34,34,34,6,34,34,34,34,6,34,6,34,34,34,34,34,34,34,
6,6,34,34,6,6,34,34,6,6,6,6,6,6,6,34,34,34,34,6,6,6,34,6,34,6,34,6,6,34,34,6,6,34,6,34,6,6,6,34,
34,6,34,6,6,6,34,6,34,34,6,34,6,34,34,6,34,34,6,34,34,34,6,34,34,34,6,34,34,6,34,6,6,6,6,34,34,34,34,34,
6,34,6,6,6,6,90,90,90,90,90,90,34,6,34,6,6,6,34,34,34,6,6,6,34,34,6,6,34,34,6,34,6,6,6,34,6,6,6,34,
34,34,6,6,34,6,90,90,90,118,90,90,90,34,34,34,34,34,6,34,6,34,34,6,34,34,6,34,34,6,34,6,6,34,34,34,6,34,34,34,
34,6,34,6,6,6,90,90,90,90,90,90,90,90,90,34,6,34,6,6,6,34,6,6,34,34,34,6,34,6,34,34,6,34,6,6,6,34,34,34,
90,90,90,90,90,90,90,90,90,34,6,6,118,90,90,34,6,6,34,6,6,6,34,6,34,6,34,34,6,34,34,34,6,6,6,34,6,34,6,34,
90,90,90,90,90,90,90,90,6,6,6,6,90,90,90,34,6,6,6,34,34,34,34,34,6,34,34,34,34,34,6,6,6,34,34,34,34,34,34,34,
34,34,34,34,34,6,6,6,34,6,34,34,6,90,90,90,90,90,34,6,34,34,34,34,34,6,34,6,34,6,6,6,6,6,6,6,34,34,34,6,
6,34,6,34,34,6,6,34,34,34,34,34,6,90,90,90,118,90,6,34,34,34,6,34,34,6,6,34,34,6,6,34,6,34,34,34,6,6,6,34,
34,6,6,34,6,34,34,34,34,34,34,6,6,90,90,90,90,90,34,34,34,6,34,6,6,6,34,6,34,34,34,34,6,6,6,6,6,34,34,6,
6,6,34,6,6,6,34,34,34,6,34,34,34,34,6,6,34,6,34,34,6,34,6,6,34,34,6,34,6,6,34,6,34,34,6,34,6,6,6,6,
6,34,34,6,34,6,6,6,34,6,34,6,6,6,6,6,6,34,6,34,6,6,6,6,6,6,34,6,6,34,34,34,34,6,6,34,34,6,34,34,
34,6,6,6,6,6,34,6,34,6,6,34,6,6,6,6,34,34,34,34,6,34,6,34,6,6,34,34,34,34,6,6,34,6,6,34,34,6,34,34,
34,34,34,6,34,34,34,34,34,34,6,34,34,34,34,34,34,34,34,6,34,34,34,6,6,6,34,6,34,6,34,6,34,34,6,34,34,6,6,34,
34,34,34,34,6,34,34,34,6,34,34,34,6,34,34,6,34,6,34,6,34,6,34,34,34,34,34,34,34,34,34,6,6,6,6,6,6,34,6,34,
34,34,6,6,6,6,6,34,34,6,6,6,34,34,6,34,6,34,34,34,6,34,34,34,34,34,34,6,34,34,34,6,34,34,34,34,34,6,34,34,
34,6,6,6,6,6,6,6,34,6,6,6,6,6,34,6,34,34,6,34,34,6,34,34,6,34,6,34,6,6,6,6,34,34,6,6,34,6,6,6,
34,34,6,34,6,6,34,34,6,34,34,34,34,6,34,6,6,34,6,34,6,34,6,34,6,6,6,34,6,34,6,6,34,34,34,34,6,6,6,34,
34,6,34,34,6,34,6,6,34,34,34,6,6,6,34,6,6,6,34,34,6,6,34,34,34,34,34,34,6,6,6,34,34,34,34,34,6,34,6,34